###################
#                 #
#            1    #
#                 #
#     #######     #
#       #####     #
#        ####     #
#         ###     #
#          ##     #
#           #     #
#                 #
#                 #
#                 #
#                 #
#                 #
#                 #
#                 #
#   0             #
#                 #
###################











